111111111111
1000000000001
1000000000001
10000N00000001
10000000000001
11111111111111
