NO ./TEXTURES/path_to_the_north_texture.xpm
SO ./TEXTURES/path_to_the_south_texture.xpm
WE ./TEXTURES/path_to_the_west_texture.xpm
EA ./TEXTURES/path_to_the_east_texture.xpm

F 50,50,50


11111111111111111111111111111
10000000001100000000000011111
1011000M011100000000000011111
10010000000D00000000000011111
11111111101100000111000000001
10000000001100000111D11111111
11110111111111D11100000010001
11110111111111011100000010001
11000000110101011100000010001
10000000000100001100N00010001
100000000M0000001101010010001
11000001110101011111011110001
11110111111010111101111010001
11111111111111111111111111111
