NO ./TEXTURES/path_to_the_north_texture.xpm
SO ./TEXTURES/path_to_the_south_texture.xpm
WE ./TEXTURES/path_to_the_west_texture.xpm
EA ./TEXTURES/path_to_the_east_texture.xpm

F 50,50,50

111111111111111111111111
100000000000D00000000001
100101000111111101111D11
1001M10001111M1100001001
100111000111101111111101
1001110000M1101100000001
1000M00001111011D1111111
100111000111101101000101
1001110000M1000100010001
1000M00001110N0101000101
1001110001110001111D1111
1001110001111D1100000001
100000000D00000000000111
100000000100000000000001
111111111111111111111111