11111111111111111111111111111
10000000001100000000000011111
1011000M011100000000000011111
10010000000100000000000011111
11111111101100000111000000001
10000000001100000111D11111111
11110111111111111100000010001
11110111111111011100000010001
110000001101010111000N0010001
10000000000100001100000010001
10000000M00000001101010010001
11000001110101011111011110001
11110111111010111101111010001
11111111111111111111111111111
